1.397050476074218750e+01
1.242313003540039062e+01
1.402844715118408203e+01
4.973657226562500000e+01
1.717448043823242188e+01
1.185319423675537109e+01
1.322096061706542969e+01
